.BbbbbbbbbbbBB............#..
.BB.BBBBbb.........BB....##..
..bbbBB..................#...
bbb......................#...
.....#.Bb..bb............#...
.....##BbBbbbb....#bbbbbb.bbb
....###BBBbbbbbbbb#.....bbbb#
....###...........#......bbb#
.....##.......G.E.#.G.......#
......bbbbbbbbbbbbbbbbbbbb###
..GM.G.........E..........###
