.#.G-........
###b.b.....b.
####.##bbbbb.
####G##......
####.b#......
####bb##bG...
b###bb##.....
b##bbb##b....
.b#bb.#......
..#...#......
..#...#......
bb#...#......
..#...#......
.G#.EE#--....
#b#bbb..bbbbM
#.#bbB#bbbbbb
#.#---#--..bb
#........bbbb
